111111111111111111111
100000001000000010001
100000001000000010001
100000001000000010001
100010000000100000001
100010000000100000001
100010000000100000001
111111111111111111111