111111111111111111111
1CCCC0001000000010001
100000001000000010001
10E000001000000010001
100010000000100000001
10P010000000100000001
100010000000100000001
111111111111111111111