1111111111111111111
1000C01000001000C01
1001001001001001001
1001001001001001001
1P010000010C00010E1
1111111111111111111