111111111111111111111
100000001000000010001
100C00001000C00010E01
100000001000000010001
100010000000100000001
10P01000C0001000C0001
100010000000100000001
111111111111111111111