111111111111111111111
100000000000000000001
10C000000000C00000001
100000000000000000001
100000000000000000001
10000P0000000000E0001
1000000000000000C0001
111111111111111111111