1111111111111111111111111111111111111111111111111111111111111
1000000000000000000000000010001000100000000000000000000000001
10P000000000000000000000001000000010C000000000000000000000E01
100000000000000000000000001000C000100000000000000000000000001
1111111111111111111111100010000000100011111111111111111111111
1000000000000000000000000010001000100000000000000000000000001
1000000000000000000000000010001000100000000000000000000000001
10C0111111111111111111111110001000111111111111111111111110C01
1000000000000000000000000000001000000000000000000000000000001
1000000000000000000000000000001000000000000000000000000000001
1000000000000000000000000000001000000000000000000000000000001
1111111111111111111111111111111111111111111111111111111111111