111111111111111111111111111111111111111111111111111111111111
100000000000000000000000000000100000000000000000000000000001
10P000000000000000000000001000000100000000000000000000000001
100000000000000000000000001000C00100000000000000000000000001
111111111111111111111110001000100100111111111111111111111111
100000000000000000000000001000100100000000000000000000000001
100000000000000000000000001000100100000000000000000000000001
10C011111111111111111111111000100111111111111111111111110001
100000000000000000000000000000100000000000000000000000000001
100000000000000000000000000000100000000000000000000000000001
100000000000000000000000000000100000000000000000000000000001
111111111111111111111111111111111111111111111111111111111111