11111111111111111111111111111111111111111111111111111111111
10000000000000000000000000100000100000000000000000000000001
10000000000000000000000000100000100000000000000000000000001
11111111111111111111111100100100100111111111111111111111111
10000000000000000000000000100100100000000000000000000000001
10000000000000000000000000100100100000000000000000000000001
10011111111111111111111111100100111111111111111111111111001
10000000000000000000000000000100000000000000000000000000001
10000000000000000000000000000100000000000000000000000000001
11111111111111111111111111111111111111111111111111111111111